 S  S  E  S  S  E  S  S  S  S  E  E  S  S  S  E  S  W  S  W 
 E  E  E  S  E  E  S  S  S  S  E  E  S  S  S  S  S  W  W  W 
 E  E  E  E  E  E  S  E  S  S  E  S  S  S  S  S  S  W  W  W 
 E  E  E  E  E  E  E  E  S  S  E  E  S  S  S  S  S  S  W  W 
 E  E  E  E  E  E  E  E  E  S  E  E  S  S  S  S  S  S  W  W 
 S  S  S  S  S  S  S  E  E  S  S  S  E  S  S  S  S  W  W  W 
 S  E  E  E  E  E  E  E  E  S  S  E  E  E  S  S  S  S  S  W 
 S  S  S  S  S  E  E  E  E  S  S  S  E  E  S  E  S  W  W  W 
 E  E  S  S  S  S  E  E  E  E  S  S  E  S  S  S  S  W  W  W 
 E  E  E  S  S  S  S  E  S  E  S  S  S  E  S  S  S  S  W  W 
 E  E  E  E  E  E  E  E  E  E  S  S  S  E  S  S  S  W  S  W 
 E  S  S  S  S  E  E  E  E  E  E  E  E  E  S  S  S  W  W  W 
 E  E  E  S  S  S  S  S  S  S  S  E  E  E  E  E  S  W  W  W 
 E  E  S  S  S  S  E  E  E  S  S  E  S  S  E  E  S  W  W  W 
 E  E  E  S  S  S  E  S  E  S  S  E  E  S  E  E  S  W  W  W 
 E  E  E  E  S  S  E  E  E  E  S  E  E  S  E  S  S  W  S  W 
 E  E  E  E  E  S  S  E  S  S  S  E  E  S  E  E  S  W  W  W 
 E  E  E  E  E  E  E  E  E  E  E  E  E  E  E  E  G  W  W  W 
 E  E  N  E  N  N  N  N  E  N  E  N  N  N  E  N  N  N  W  W 
 N  N  N  N  N  N  N  N  N  N  N  N  N  N  N  N  N  W  N  W 
